##############################
#                            #
#   #########                #
#           #     ####       #
#           #                #
#           #                #
#           ###########      #
#                            #
#    ##########              #
#                            #
##############################